UOH = "countries/Union of Haven.txt"
HSY = "countries/Hearthstone Yuldai.txt"
SAV = "countries/Savernia.txt"
PAL = "countries/Paloro.txt"
AUR = "countries/Aurora.txt"
VIN = "countries/Vinovia.txt"
LOR = "countries/Lorent.txt"
FRO = "countries/Frostmarch.txt"
TOR = "countries/Tortuga.txt"
CON = "countries/Consau.txt"
AAT = "countries/Aatyelli.txt"
FRI = "countries/Friholm.txt"
VAL = "countries/Valandor.txt"
AVA = "countries/Avaria.txt"
IAU = "countries/Imperial Archonal Union.txt"
BOR = "countries/Borhammar.txt"
AEZ = "countries/Aezenfjord.txt"
REG = "countries/Regonia.txt"
AVE = "countries/Avertico.txt"
VIR = "countries/Viratayn.txt"
TCC = "countries/Tecca.txt"
ATL = "countries/Atlantia.txt"
YAS = "countries/Yaszria.txt"
AKH = "countries/Alokhrad.txt"
CZR = "countries/Czervoslavia.txt"
VAN = "countries/Vanyr.txt"
ZEF = "countries/Zefrania.txt"
TEG = "countries/Tegridy.txt"
LUX = "countries/Lux.txt"
HUI = "countries/Huitca.txt"
AAZ = "countries/Ardat-Azael.txt"
KOC = "countries/Kingdom of Councils.txt"
VOL = "countries/Volstronn.txt"
LIR = "countries/Lirgal.txt"
ADA = "countries/Adashira.txt"
SIR = "countries/Sironia.txt"
CAR = "countries/Carn.txt"
DRA = "countries/Dracade.txt"
OMB = "countries/Ombria.txt"
SAN = "countries/Sanctum.txt"
VUL = "countries/Vulperium.txt"
DEN = "countries/Denthros.txt"
GSH = "countries/Goshuma District.txt"
AYN = "countries/Alamayn.txt"
CHU = "countries/Chumon Ito.txt"
SLI = "countries/Solitudinem.txt"
ARL = "countries/Arlinovla.txt"
NOA = "countries/Novia.txt"
KAR = "countries/Kartek.txt"
CER = "countries/Certaria.txt"
VOS = "countries/Vostok.txt"
JAM = "countries/Jamestown.txt"
KYR = "countries/Kyrston.txt"
ECC = "countries/Ecclesia.txt"
HEI = "countries/Heimstadt.txt"
DAP = "countries/Daphentesca.txt"
CAS = "countries/Castell.txt"
NOV = "countries/Novareach.txt"
ARD = "countries/Ardagia.txt"
SEI = "countries/Seidora.txt"
VRA = "countries/Vraelea.txt"
VGD = "countries/Voskograd.txt"
OPC = "countries/Osteri Plagosi Trade Company.txt"
NAJ = "countries/Najer.txt"
SHN = "countries/Seahaven.txt"
LUN = "countries/Lunaris.txt"
THE = "countries/Theros.txt"
DRK = "countries/Drakonia.txt"
SIM = "countries/Simulami.txt"
YIM = "countries/Yimmu-Audal.txt"
GRT = "countries/Gertonia.txt"
IMP = "countries/Imperium.txt"
AZU = "countries/Azuria.txt"
YES = "countries/Yestanbul.txt"
MAG = "countries/Magisterium.txt"
ALD = "countries/Alda.txt"
RYZ = "countries/Ryzan.txt"
JUN = "countries/Juno.txt"
AVD = "countries/Aurlunor Velande.txt"
GOL = "countries/Goldburg.txt"
GAN = "countries/Ganeffstan.txt"
AND = "countries/Andorn.txt"
NOR = "countries/Norfthorn.txt"
ASK = "countries/Askonia.txt"
RIC = "countries/Richteria.txt"
WIV = "countries/Wivamovia.txt"
TTT = "countries/Three Thrones.txt"
AZD = "countries/Azurov's Domain.txt"
POL = "countries/Polikos.txt"
DLR = "countries/Daelyria.txt"
CHA = "countries/Chanels.txt"
NRG = "countries/Nova Regna.txt"
DON = "countries/Don Fuer.txt"
SKJ = "countries/Skjoldbrothir.txt"
URC = "countries/Urcastle.txt"
AMB = "countries/Amberia.txt"
NVS = "countries/Norvos.txt"
ATO = "countries/Ato.txt"
ITA = "countries/Italian't.txt"
GRE = "countries/Greenland.txt"
KUS = "countries/Kush.txt"
BAR = "countries/Bardonia.txt"
KAZ = "countries/Kush.txt"
VER = "countries/Vereblock.txt"
VSH = "countries/Vanshae.txt"
COL = "countries/Coltmaere.txt"
ONU = "countries/ONU.txt"
VKR = "countries/Vanakunir.txt"
PFA = "countries/Paz Firainya.txt"
ROM = "countries/Romash.txt"
CAE = "countries/Caeli.txt"
SKA = "countries/Skadovsk.txt"
ZEM = "countries/Zemlya.txt"
TES = "countries/Tessel.txt"
JAD = "countries/Jade.txt"
SEX = "countries/Sex.txt"
LUM = "countries/Lumaire.txt"
LEV = "countries/Leveros.txt"
KHA = "countries/Khand.txt"
KRO = "countries/Kronesia.txt"
FEA = "countries/Featherian Federation.txt"
ASH = "countries/Ashura.txt"
SAL = "countries/Salmongrad.txt"
PAU = "countries/Posavertico.txt"
AET = "countries/Aetheria.txt"
NDR = "countries/New Dorasterrock.txt"
VLR = "countries/Valdreach.txt"