UOH = "countries/Union of Haven.txt"
HSY = "countries/Hearthstone Yuldai.txt"
SAV = "countries/Savernia"
PAL = "countries/Paloro"
AUR = "countries/Aurora"
VIN = "countries/Vinovia"
LOR = "countries/Lorent"
FRO = "countries/Frostmarch"
TOR = "countries/Tortuga"
CON = "countries/Consau"
AAT = "countries/Aatyelli"
FRI = "countries/Friholm"
VAL = "countries/Valandor"
AVA = "countries/Avaria"
IAU = "countries/Imperial Archonal Union"
BOR = "countries/Borhammar"
AEZ = "countries/Aezenfjord"
REG = "countries/Regonia"
AVE = "countries/Avertico"
VIR = "countries/Viratayn"
TCC = "countries/Tecca"
ATL = "countries/Atlantia"
YAS = "countries/Yaszria"
AKH = "countries/Alokhrad"
CZR = "countries/Czervoslavia"
VAN = "countries/Vanyr"
ZEF = "countries/Zefrania"
TEG = "countries/Tegridy"
LUX = "countries/Lux"
HUI = "countries/Huitca"
AAZ = "countries/Ardat-Azael"
KOC = "countries/Kingdom of Councils"
VOL = "countries/Volstronn"
LIR = "countries/Lirgal"
ADA = "countries/Adashira"
SIR = "countries/Sironia"
CAR = "countries/Carn"
DRA = "countries/Dracade"
OMB = "countries/Ombria"
SAN = "countries/Sanctum"
VUL = "countries/Vulperium"
DEN = "countries/Denthros"
GSH = "countries/Goshuma District"
AYN = "countries/Alamayn"
CHU = "countries/Chumon Ito"
SLI = "countries/Solitudinem"
ARL = "countries/Arlinovla"
NOA = "countries/Novia"
KAR = "countries/Kartek"
CER = "countries/Certaria"
VOS = "countries/Vostok"
JAM = "countries/Jamestown"
KYR = "countries/Kyrston"
ECC = "countries/Ecclesia"
HEI = "countries/Heimstadt"
DAP = "countries/Daphentesca"
CAS = "countries/Castell"
NOV = "countries/Novareach"
ARD = "countries/Ardagia"
SEI = "countries/Seidora"
VRA = "countries/Vraelea"
VGD = "countries/Voskograd"
OPC = "countries/Osteri Plagosi Trade Company"
NAJ = "countries/Najer"
SHN = "countries/Seahaven"
LUN = "countries/Lunaris"
THE = "countries/Theros"
DRK = "countries/Drakonia"
SIM = "countries/Simulami"
YIM = "countries/Yimmu-Audal"
GRT = "countries/Gertonia"
IMP = "countries/Imperium"
AZU = "countries/Azuria"
YES = "countries/Yestanbul"
MAG = "countries/Magisterium"
ALD = "countries/Alda"
RYZ = "countries/Ryzan"
JUN = "countries/Juno"
AVD = "countries/Aurlunor Velande"
GOL = "countries/Goldburg"
GAN = "countries/Ganeffstan"
AND = "countries/Andorn"
NOR = "countries/Northorn"
ASK = "countries/Askonia"
RIC = "countries/Richteria"
WIV = "countries/Wivamoviaz"
TTT = "countries/Three Thrones"
AZD = "countries/Azurov's Domain"
POL = "countries/Polikos"
DLR = "countries/Daelyria"